"filename", "language", "YAML", "C#", "comment", "blank", "total"
"e:\UnityLiabrary\Brother Plant\Assets\Scripts\Camera.meta", "YAML", 8, 0, 0, 1, 9
"e:\UnityLiabrary\Brother Plant\Assets\Scripts\Camera\CameraFollow.cs", "C#", 0, 108, 4, 19, 131
"e:\UnityLiabrary\Brother Plant\Assets\Scripts\Camera\CameraFollow.cs.meta", "YAML", 11, 0, 0, 1, 12
"e:\UnityLiabrary\Brother Plant\Assets\Scripts\Common.meta", "YAML", 8, 0, 0, 1, 9
"e:\UnityLiabrary\Brother Plant\Assets\Scripts\Common\CharacterStats.cs", "C#", 0, 78, 11, 19, 108
"e:\UnityLiabrary\Brother Plant\Assets\Scripts\Common\CharacterStats.cs.meta", "YAML", 11, 0, 0, 1, 12
"e:\UnityLiabrary\Brother Plant\Assets\Scripts\Common\SunCollectible.cs", "C#", 0, 64, 5, 18, 87
"e:\UnityLiabrary\Brother Plant\Assets\Scripts\Common\SunCollectible.cs.meta", "YAML", 11, 0, 0, 1, 12
"e:\UnityLiabrary\Brother Plant\Assets\Scripts\Enemy.meta", "YAML", 8, 0, 0, 1, 9
"e:\UnityLiabrary\Brother Plant\Assets\Scripts\Enemy\Enemy.cs", "C#", 0, 24, 3, 8, 35
"e:\UnityLiabrary\Brother Plant\Assets\Scripts\Enemy\Enemy.cs.meta", "YAML", 11, 0, 0, 1, 12
"e:\UnityLiabrary\Brother Plant\Assets\Scripts\Enemy\EnemyAttributeDataBase.cs", "C#", 0, 65, 0, 19, 84
"e:\UnityLiabrary\Brother Plant\Assets\Scripts\Enemy\EnemyAttributeDataBase.cs.meta", "YAML", 11, 0, 0, 1, 12
"e:\UnityLiabrary\Brother Plant\Assets\Scripts\Enemy\EnemyStats.cs", "C#", 0, 46, 2, 9, 57
"e:\UnityLiabrary\Brother Plant\Assets\Scripts\Enemy\EnemyStats.cs.meta", "YAML", 11, 0, 0, 1, 12
"e:\UnityLiabrary\Brother Plant\Assets\Scripts\Enemy\EnemyStatusSystem.cs", "C#", 0, 261, 4, 37, 302
"e:\UnityLiabrary\Brother Plant\Assets\Scripts\Enemy\EnemyStatusSystem.cs.meta", "YAML", 11, 0, 0, 1, 12
"e:\UnityLiabrary\Brother Plant\Assets\Scripts\Enemy\Ordinary zombie.meta", "YAML", 8, 0, 0, 1, 9
"e:\UnityLiabrary\Brother Plant\Assets\Scripts\Enemy\Ordinary zombie\DropHead.cs", "C#", 0, 10, 0, 2, 12
"e:\UnityLiabrary\Brother Plant\Assets\Scripts\Enemy\Ordinary zombie\DropHead.cs.meta", "YAML", 11, 0, 0, 1, 12
"e:\UnityLiabrary\Brother Plant\Assets\Scripts\Enemy\Ordinary zombie\OrdinaryZombie.cs", "C#", 0, 176, 1, 24, 201
"e:\UnityLiabrary\Brother Plant\Assets\Scripts\Enemy\Ordinary zombie\OrdinaryZombie.cs.meta", "YAML", 11, 0, 0, 1, 12
"e:\UnityLiabrary\Brother Plant\Assets\Scripts\GameManager.meta", "YAML", 8, 0, 0, 1, 9
"e:\UnityLiabrary\Brother Plant\Assets\Scripts\GameManager\EnemySpawn.cs", "C#", 0, 103, 6, 24, 133
"e:\UnityLiabrary\Brother Plant\Assets\Scripts\GameManager\EnemySpawn.cs.meta", "YAML", 11, 0, 0, 1, 12
"e:\UnityLiabrary\Brother Plant\Assets\Scripts\GameManager\GameManager.cs", "C#", 0, 289, 1, 39, 329
"e:\UnityLiabrary\Brother Plant\Assets\Scripts\GameManager\GameManager.cs.meta", "YAML", 11, 0, 0, 1, 12
"e:\UnityLiabrary\Brother Plant\Assets\Scripts\GameManager\MusicController.cs", "C#", 0, 12, 2, 5, 19
"e:\UnityLiabrary\Brother Plant\Assets\Scripts\GameManager\MusicController.cs.meta", "YAML", 11, 0, 0, 1, 12
"e:\UnityLiabrary\Brother Plant\Assets\Scripts\GameManager\SunController.cs", "C#", 0, 98, 2, 21, 121
"e:\UnityLiabrary\Brother Plant\Assets\Scripts\GameManager\SunController.cs.meta", "YAML", 11, 0, 0, 1, 12
"e:\UnityLiabrary\Brother Plant\Assets\Scripts\GameManager\UIController.cs", "C#", 0, 53, 0, 10, 63
"e:\UnityLiabrary\Brother Plant\Assets\Scripts\GameManager\UIController.cs.meta", "YAML", 11, 0, 0, 1, 12
"e:\UnityLiabrary\Brother Plant\Assets\Scripts\Player.meta", "YAML", 8, 0, 0, 1, 9
"e:\UnityLiabrary\Brother Plant\Assets\Scripts\Player\Player.cs", "C#", 0, 66, 3, 16, 85
"e:\UnityLiabrary\Brother Plant\Assets\Scripts\Player\Player.cs.meta", "YAML", 11, 0, 0, 1, 12
"e:\UnityLiabrary\Brother Plant\Assets\Scripts\Player\PlayerAttributeDataBase.cs", "C#", 0, 69, 0, 21, 90
"e:\UnityLiabrary\Brother Plant\Assets\Scripts\Player\PlayerAttributeDataBase.cs.meta", "YAML", 11, 0, 0, 1, 12
"e:\UnityLiabrary\Brother Plant\Assets\Scripts\Player\PlayerMove.cs", "C#", 0, 65, 6, 14, 85
"e:\UnityLiabrary\Brother Plant\Assets\Scripts\Player\PlayerMove.cs.meta", "YAML", 11, 0, 0, 1, 12
"e:\UnityLiabrary\Brother Plant\Assets\Scripts\Player\PlayerStats.cs", "C#", 0, 34, 0, 5, 39
"e:\UnityLiabrary\Brother Plant\Assets\Scripts\Player\PlayerStats.cs.meta", "YAML", 11, 0, 0, 1, 12
"e:\UnityLiabrary\Brother Plant\Assets\Scripts\UI.meta", "YAML", 8, 0, 0, 1, 9
"e:\UnityLiabrary\Brother Plant\Assets\Scripts\UI\DamagePopup.cs", "C#", 0, 50, 1, 13, 64
"e:\UnityLiabrary\Brother Plant\Assets\Scripts\UI\DamagePopup.cs.meta", "YAML", 11, 0, 0, 1, 12
"e:\UnityLiabrary\Brother Plant\Assets\Scripts\UI\HealthUI.cs", "C#", 0, 27, 0, 8, 35
"e:\UnityLiabrary\Brother Plant\Assets\Scripts\UI\HealthUI.cs.meta", "YAML", 11, 0, 0, 1, 12
"e:\UnityLiabrary\Brother Plant\Assets\Scripts\UI\SunUI.cs", "C#", 0, 79, 1, 14, 94
"e:\UnityLiabrary\Brother Plant\Assets\Scripts\UI\SunUI.cs.meta", "YAML", 11, 0, 0, 1, 12
"e:\UnityLiabrary\Brother Plant\Assets\Scripts\Weapon.meta", "YAML", 8, 0, 0, 1, 9
"e:\UnityLiabrary\Brother Plant\Assets\Scripts\Weapon\DoublePeaShooter.meta", "YAML", 8, 0, 0, 1, 9
"e:\UnityLiabrary\Brother Plant\Assets\Scripts\Weapon\DoublePeaShooter\DoublePeaHitEffect.cs", "C#", 0, 8, 0, 2, 10
"e:\UnityLiabrary\Brother Plant\Assets\Scripts\Weapon\DoublePeaShooter\DoublePeaHitEffect.cs.meta", "YAML", 11, 0, 0, 1, 12
"e:\UnityLiabrary\Brother Plant\Assets\Scripts\Weapon\DoublePeaShooter\DoublePeaProjectile.cs", "C#", 0, 46, 4, 11, 61
"e:\UnityLiabrary\Brother Plant\Assets\Scripts\Weapon\DoublePeaShooter\DoublePeaProjectile.cs.meta", "YAML", 11, 0, 0, 1, 12
"e:\UnityLiabrary\Brother Plant\Assets\Scripts\Weapon\DoublePeaShooter\DoublePeaShooterWeapon.cs", "C#", 0, 82, 2, 17, 101
"e:\UnityLiabrary\Brother Plant\Assets\Scripts\Weapon\DoublePeaShooter\DoublePeaShooterWeapon.cs.meta", "YAML", 11, 0, 0, 1, 12
"e:\UnityLiabrary\Brother Plant\Assets\Scripts\Weapon\GatlingPeaShooter.meta", "YAML", 8, 0, 0, 1, 9
"e:\UnityLiabrary\Brother Plant\Assets\Scripts\Weapon\GatlingPeaShooter\GatlingPeaHitEffect.cs", "C#", 0, 8, 0, 2, 10
"e:\UnityLiabrary\Brother Plant\Assets\Scripts\Weapon\GatlingPeaShooter\GatlingPeaHitEffect.cs.meta", "YAML", 11, 0, 0, 1, 12
"e:\UnityLiabrary\Brother Plant\Assets\Scripts\Weapon\GatlingPeaShooter\GatlingPeaProjectile.cs", "C#", 0, 46, 4, 11, 61
"e:\UnityLiabrary\Brother Plant\Assets\Scripts\Weapon\GatlingPeaShooter\GatlingPeaProjectile.cs.meta", "YAML", 11, 0, 0, 1, 12
"e:\UnityLiabrary\Brother Plant\Assets\Scripts\Weapon\GatlingPeaShooter\GatlingPeaShooterWeapon.cs", "C#", 0, 82, 2, 18, 102
"e:\UnityLiabrary\Brother Plant\Assets\Scripts\Weapon\GatlingPeaShooter\GatlingPeaShooterWeapon.cs.meta", "YAML", 11, 0, 0, 1, 12
"e:\UnityLiabrary\Brother Plant\Assets\Scripts\Weapon\IceShooter.meta", "YAML", 8, 0, 0, 1, 9
"e:\UnityLiabrary\Brother Plant\Assets\Scripts\Weapon\IceShooter\IceHitEffect.cs", "C#", 0, 8, 0, 2, 10
"e:\UnityLiabrary\Brother Plant\Assets\Scripts\Weapon\IceShooter\IceHitEffect.cs.meta", "YAML", 11, 0, 0, 1, 12
"e:\UnityLiabrary\Brother Plant\Assets\Scripts\Weapon\IceShooter\IceProjectile.cs", "C#", 0, 49, 4, 12, 65
"e:\UnityLiabrary\Brother Plant\Assets\Scripts\Weapon\IceShooter\IceProjectile.cs.meta", "YAML", 11, 0, 0, 1, 12
"e:\UnityLiabrary\Brother Plant\Assets\Scripts\Weapon\IceShooter\IceShooterWeapon.cs", "C#", 0, 86, 2, 18, 106
"e:\UnityLiabrary\Brother Plant\Assets\Scripts\Weapon\IceShooter\IceShooterWeapon.cs.meta", "YAML", 11, 0, 0, 1, 12
"e:\UnityLiabrary\Brother Plant\Assets\Scripts\Weapon\Jalapeno.meta", "YAML", 8, 0, 0, 1, 9
"e:\UnityLiabrary\Brother Plant\Assets\Scripts\Weapon\Jalapeno\FireProjectile.cs", "C#", 0, 41, 2, 9, 52
"e:\UnityLiabrary\Brother Plant\Assets\Scripts\Weapon\Jalapeno\FireProjectile.cs.meta", "YAML", 11, 0, 0, 1, 12
"e:\UnityLiabrary\Brother Plant\Assets\Scripts\Weapon\Jalapeno\JalapenoWeapon.cs", "C#", 0, 86, 2, 18, 106
"e:\UnityLiabrary\Brother Plant\Assets\Scripts\Weapon\Jalapeno\JalapenoWeapon.cs.meta", "YAML", 11, 0, 0, 1, 12
"e:\UnityLiabrary\Brother Plant\Assets\Scripts\Weapon\PeaShooter.meta", "YAML", 8, 0, 0, 1, 9
"e:\UnityLiabrary\Brother Plant\Assets\Scripts\Weapon\PeaShooter\PeaHitEffect.cs", "C#", 0, 8, 0, 2, 10
"e:\UnityLiabrary\Brother Plant\Assets\Scripts\Weapon\PeaShooter\PeaHitEffect.cs.meta", "YAML", 11, 0, 0, 1, 12
"e:\UnityLiabrary\Brother Plant\Assets\Scripts\Weapon\PeaShooter\PeaProjectile.cs", "C#", 0, 44, 4, 10, 58
"e:\UnityLiabrary\Brother Plant\Assets\Scripts\Weapon\PeaShooter\PeaProjectile.cs.meta", "YAML", 11, 0, 0, 1, 12
"e:\UnityLiabrary\Brother Plant\Assets\Scripts\Weapon\PeaShooter\PeaShooterWeapon.cs", "C#", 0, 80, 2, 16, 98
"e:\UnityLiabrary\Brother Plant\Assets\Scripts\Weapon\PeaShooter\PeaShooterWeapon.cs.meta", "YAML", 11, 0, 0, 1, 12
"e:\UnityLiabrary\Brother Plant\Assets\Scripts\Weapon\WeaponBase.cs", "C#", 0, 62, 0, 13, 75
"e:\UnityLiabrary\Brother Plant\Assets\Scripts\Weapon\WeaponBase.cs.meta", "YAML", 11, 0, 0, 1, 12
"e:\UnityLiabrary\Brother Plant\Assets\Scripts\Weapon\WeaponDataBase.cs", "C#", 0, 49, 1, 9, 59
"e:\UnityLiabrary\Brother Plant\Assets\Scripts\Weapon\WeaponDataBase.cs.meta", "YAML", 11, 0, 0, 1, 12
"e:\UnityLiabrary\Brother Plant\Assets\Scripts\Weapon\WeaponManager.cs", "C#", 0, 129, 2, 30, 161
"e:\UnityLiabrary\Brother Plant\Assets\Scripts\Weapon\WeaponManager.cs.meta", "YAML", 11, 0, 0, 1, 12
"Total", "-", 522, 2691, 83, 596, 3892